"211"工程大学名单
北京(26所) 	清华大学 微博 	北京大学 微博 	中国人民大学
北京工业大学 	北京理工大学 	北京航空航天大学
北京化工大学 微博 	北京邮电大学 微博 	对外经济贸易大学
中国传媒大学 微博 	中央民族大学 微博 	中国矿业大学(北京)
中央财经大学 微博 	中国政法大学 微博 	中国石油大学(北京)
中央音乐学院 微博 	北京体育大学 	北京外国语大学 微博
北京交通大学 微博 	北京科技大学 微博 	北京林业大学
中国农业大学 微博 	北京中医药大学 	华北电力大学(北京) 微博
北京师范大学 微博 	中国地质大学(北京) 微博
上海(9所) 	复旦大学 微博 	华东师范大学 微博 	上海外国语大学 微博
上海大学 	同济大学 微博 	华东理工大学
东华大学 微博 	上海财经大学 	上海交通大学
天津(4所) 	南开大学 微博 	天津大学 微博 	天津医科大学 微博 
重庆(2所) 	重庆大学 微博 	西南大学 微博 	 
河北(1所) 	华北电力大学(保定) 	河北工业大学 	 
山西(1所) 	太原理工大学 	  	 
内蒙古(1所) 	内蒙古大学 	  	 
辽宁(4所) 	大连理工大学 	东北大学 微博 	辽宁大学 微博
大连海事大学 	  	 
吉林(3所) 	吉林大学 微博 	东北师范大学 	延边大学
黑龙江(4所) 	东北农业大学 微博 	东北林业大学 微博 	哈尔滨工业大学 微博
哈尔滨工程大学 微博 	  	 
江苏(11所) 	南京大学 微博 	东南大学 微博 	苏州大学
河海大学 微博 	中国药科大学 微博 	中国矿业大学(徐州) 微博
南京师范大学 微博 	南京理工大学 微博 	南京航空航天大学 微博
江南大学 微博 	南京农业大学 微博 	 
浙江(1所) 	浙江大学 微博 	  	 
安徽(3所) 	安徽大学 微博 	合肥工业大学 微博 	中国科学技术大学 微博
福建(2所) 	厦门大学 微博 	福州大学 	 
江西(1所) 	南昌大学 	  	 
山东(3所) 	山东大学 微博 	中国海洋大学 微博 	中国石油大学(华东) 微博
河南(1所) 	郑州大学 微博 	  	 
湖北(7所) 	武汉大学 微博 	华中科技大学 微博 	中国地质大学(武汉) 微博
华中师范大学 微博 	华中农业大学 微博 	中南财经政法大学 微博
武汉理工大学 微博 	  	 
湖南(3所) 	湖南大学 微博 	中南大学微博 	湖南师范大学 微博
广东(4所) 	中山大学 微博 	暨南大学 微博 	华南理工大学 微博
华南师范大学 	  	 
广西(1所) 	广西大学 	  	 
四川(5所) 	四川大学 	西南交通大学 微博 	电子科技大学 微博
西南财经大学 	四川农业大学 微博 	 
云南(1所) 	云南大学 微博 	  	 
贵州(1所) 	贵州大学 微博 	  	 
陕西(7所) 	西北大学 微博 	西安交通大学 微博 	西北工业大学 微博
陕西师范大学 微博 	西北农林科大 微博 	西安电子科技大学 微博
长安大学 微博 	  	 
甘肃(1所) 	兰州大学 微博 	  	 
新疆(2所) 	新疆大学 	 石河子大学 微博 	 
海南(1所) 	海南大学 	  	 
宁夏(1所) 	宁夏大学 微博 	  	 
青海(1所) 	青海大学 微博 	  	 
西藏(1所) 	西藏大学 	  	 
军事系统(3所) 	第二军医大学 	第四军医大学 	国防科学技术大学


一期（34所）
清华大学 微博 	北京大学 微博 	厦门大学 微博
南京大学 微博 	复旦大学 微博 	天津大学 微博
浙江大学 微博 	南开大学 微博 	西安交通大学 微博
东南大学 微博 	武汉大学 微博 	上海交通大学
山东大学 微博 	湖南大学 微博 	中国人民大学
吉林大学 微博 	重庆大学 微博 	电子科技大学 微博
四川大学 	中山大学 微博 	华南理工大学 微博
兰州大学 微博 	东北大学 微博 	西北工业大学 微博
哈尔滨工业大学 微博 	华中科技大学 微博 	中国海洋大学 微博
北京理工大学 	大连理工大学 	北京航空航天大学
北京师范大学 微博 	同济大学 微博 	中南大学 微博
中国科学技术大学 微博 	  	
二期（5所）
中国农业大学 微博 	国防科学技术大学 	中央民族大学 微博
华东师范大学 微博 	西北农林科技大学 微博 	 